-----------
|         |
|         |
|   ...   |
|         |
|         |
-----------