----------
|        |
|  ..    |
|  ..    |
|        |
----------
