--------------------------
|  .                     |
|   .                    |
| ...                    |
|                        |
|                        |
|                        |
|                        |
|                        |
|                        |
|                        |
|                        |
|                        |
|                        |
|                        |
|                        |
|                        |
|                        |
--------------------------
