----------
| .   .. |
|. . . . |
| ...   .|
|  . ..  |
----------