-----------------
|               |
|   ...   ...   |
|               |
| .    . .    . |
| .    . .    . |
| .    . .    . |
|   ...   ...   |
|               |
|   ...   ...   |
| .    . .    . |
| .    . .    . |
| .    . .    . |
|               |
|   ...   ...   |
|               |
-----------------
