--------------------------------------------------------------------------
|                                                                        |
|                                                                    .  .|
|                                                                   .    |
|                                                                   .   .|
|                                                                   .... |
|                                                                        |
|                                                                        |
|                                                                        |
--------------------------------------------------------------------------