---------------------
|                   |
|                   |
|                   |
|         .         |
|        ...        |
|                   |
|                   |
|                   |
|                   |
---------------------